11111111111111111111111111
1P00000000000000C0000000E1
11111111111111111110001111
100000000000000000000000C1
11111101111111111111111111
1C000000000000000000000001
1111111111111111111111111