111111111111111
1P000100C001001
101111100111111
1000000000000E1
111111111111111