11111111
1P0CE011
100C0011
11111111