1111111111111
100000P000101
1000000000101
1000000000101
10C00000000E1
1111111111111